-------------------------
-                       -
-                       -
-            !          -
-            --         -
-                       -
---                     -
-                    &  -
-                   --- -
-                       -
-                --     -
-     ----              -
-    &   @              -
-   ----------          -
-                       -
-                -  &   -
-                   -   -
-                     ---
-                 &   *-
-------------------------