-------------------------
-                       -
-                       -
- ----                  -
-            --         -
-                       -
-                       -
-    ---                -
-                   --- -
---                     -
-                       -
-                       -
-                       -
-      --------         -
-                       -
-                -      -
----                --  -
-                       -
-      @                -
-------------------------