-------------------------
-                       -
-                       -
-            !          -
-            --         -
-                       -
--                      -
-                       -
-                   --- -
-                       -
-                       -
-      ---              -
-       @   &           -
-   -----------         -
-                       -
-                -      -
-                   --  -
-                       -
-        &          &   *
-------------------------